10 10 0 0 9 9
5 3 4 2 2 3 4 2 2 5
3 3 3 3 2 3 3 3 3 2
3 1 2 1 3 1 2 1 3 0
0 2 3 4 3 2 3 4 3 4
4 1 4 3 2 1 4 3 2 1
5 3 4 2 2 3 4 2 2 5
3 3 3 3 2 3 3 3 3 2
3 1 2 1 3 1 2 1 3 0
0 2 3 4 3 2 3 4 3 4
4 1 4 3 2 1 4 3 2 1 f
5 5 0 0 3 0
3 4 2 2 2
3 3 3 3 2
3 1 2 1 3
0 2 3 4 3
4 1 4 3 2
5 5 0 0 1 3
3 4 1 3 1
3 3 3 0 2
3 1 2 2 3
4 2 3 3 3
4 1 4 3 2
0
